11111111111111
10000000000001111
10000111000000001
10000101000000011
11000000000000001
10000000011100001
11110000000000111
   111111111111