 111111111
 100000001                                   11111
 100000001                                   10001
 1000000011111111111111111111111111111111111110001
 1000000000000000000000000000000000000000000000001
 1000000011111111111111111111111111111111111110001
 100000001                                   10001
 100000001                                   11111
 111111111