NO ./assets/north.xpm
SO   ./assets/south.xpm
WE     ./assets/west.xpm
EA   ./assets/east.xpm

     F    255  ,  248  ,  220




C 125   ,206,  250

        1111111111111111111111111
111111111000000001000M00000000001
        1011000001000000000010001
        1001000001000000000000001
111111111011000000000000000000001
100000000011000M000000S0000111111
10110000000000000000000000001
10111111111110000000000000001
1000001     10011100000000001
10000011111110001100000000001
100M0011000000000000000000001
11000001110101011111111C11111111
11110001 1110101 100000M00001
11111111 1111111 111111111111